11111111111111111111
1E0000N00C000C0P0001
10100010101001010101
10101100010100010101
1P00C00C00E000N000C1
11111111111111111111
