1111111111111
1000000P00001
1E0000000001
100000C000001
1111111111111
