1111111111111
1000000P00001
1E00000000000
100000C000001
1111111111111
