111111111111
1000C0100001
1E000010P001
100000000001
111111111111
