111111111111111111111111111111
1E00000000N00000C00000C0P00001
101001010010000010100100010101
101001001010101000100100010101
1P0000000C00C0000000E000N000C1
111111111111111111111111111111
