1111111111111
10000000C0001
1E0000U000001
1000000P00001
1111111111111
