1111111111111
1000C00000001
1E00000P00001
1000000000001
1111111111111
